NO ./path_to_the_north_texture
SO ./path_to_the_south_texture
WE ./path_to_the_west_texture
EA ./path_to_the_east_texture


F 220,100,0
C 225,30,0












111
101
101
10111111111
10000000001
11110011111
11110011111
11110011111
11111111111









